TTTTTTTTTTTTTTTTTTTTTTTTTTTTTTTTTTTTTTTTTTTTTTTTTTTTTTTTTTTTTTTTTTTTTTTTTTTTTTTTTTTTTTTTTTTTTTTTTTTT
T                                                                                                  T
T                                                                                                  T
T       |^^^^^|                                                                      |^^^^^|       T
T        \###/                                                                        \###/        T
T        |___|                                                                        |___|        T
T       /_____\                                                                      /_____\       T
T                                                                                                  T
T                                                                                                  T
T                                                                                                  T
T                                                                                                  T
T                                                                                                  T
T                                                                                                  T
T                                                                                                  T
T                                                                                                  T
T                                                                                                  T
T                                                                                                  T
T                                                                                                  T
T                                                                                                  T
T                                                                                                  T
T                                                                                                  T
T                                                                                                  T
T                                                                                                  T
<                                                                                                  T
<                                                                                                  T
<                                                                                                  T
T                                                                                                  T
T                                                                                                  T
T                                                                                                  T
T                                                                                                  T
T                                                                                                  T
T                                                                                                  T
T       |^^^^^|                                                                      |^^^^^|       T
T        \###/                                                                        \###/        T
T        |___|                                                                        |___|        T
T       /_____\                                                                      /_____\       T
T                                                                                                  T
T                                                                                                  T
T                                                                                                  T
TTTTTTTTTTTTTTTTTTTTTTTTTTTTTTTTTTTTTTTTTTTTTTTTTTTTTTTTTTTTTTTTTTTTTTTTTTTTTTTTTTTTTTTTTTTTTTTTTTTT